10 10
____X_____
____X___F_
____X_____
____X_____
_XXXX_____
____X_____
____X_____
____X___X_
____X_____
__________