100 100
__X__X__XX_X____________XX____X___X__XXXX___XX_XX_X__X____X__XX________X_______X___XXXX___X__X___X__
X__X_XXXXXX___X__XXXXX__X__X__X_____XXXX___X______X___X_X_X__X_X__XX__________XXX__XXX________X__X__
____X________X_X_X__XX__XXX_XXX____________X___XX___X_________XX_X_X_XX_X_XXX____________XX_______X_
_X_____XX___X__X__X_X__X___X_____X_X_XX______X_____X__X_X___X__X_XXX_XX____XX__X__X__X_XX___X___X_X_
__X_XX_X__XX__X___X__X___X___X_X___________XXXX__X_X_X_X________X_________XX__XXX_X_XXX__________X__
____X__X_X_XX____________X_XXXX_XX______X_____________XX__X_XX_______XX____XX____X_______XXXX_XXX_X_
X__X_____X___X__X____X_X__X__X_______X______X_____XXX___X__X_____XX_XX______XX_XXX___X____XX________
__XXXX_X______X_XX_X_X__X___X_____X__X______X______XX___X____X_XXX_XXX___X_XX__X___________X___X____
_XX________XXX_______X__XXXXX__________X__X___XX_X_X___XX__X__X_____X____X________X_XX__________XX__
__XXX__________XXXX______X_____X___X__XXX_X__X_X_______X__X__X_X_X_________X________X____X___X__X___
XXX___X___X_X_X_X_X________X_____X_____X_____X_X____X__X___X_XX____XX__X____XX__XXX__X__X___________
_______XX_____X__X_XXX__X_______________XX__X__X___XX____X_X_____X_______X__XXXXX___X_______________
X__X_______X_XXX_X____X_XX_____XXXXXXX_X___X__XX____X____________X____X___X________X_XX__XX____X_X__
_X___XX___XX_X___XX_X____X_X_X___X______X_____X_XX_____X_X____X__X___X____X_______X____X____X__X_X__
__XX____X__XX_____X___X______X_____X_XXX_X____XX__X______XX__XXX__X_______________XX_X__XXXX__X_____
_XXX____XX_X____XX_XX_________XX_______XXX__X_XX_X__X_X____________X___X_____X_______X__X__XX___XXX_
___XX____XX_X_X_X_X___X__XX_________________XX__XXX____XX_X_____X____X_____X_XX___X_X__X____________
X_X_X_X_____XX___X________XX____X____XX_X____XX____XX_________XXXXX______X______XX_____X___X___X____
_____X_______X_X__________X__X_X______XXX____X__X_____XX___________X__X_X_____X_X_____X__X__X_XX__X_
X_____X____X_______XX____XXX______XX____X______X_X__X_______X______X____XX__X_____X__XXX__XX_X_X__X_
___XX______X______X_XX__XX____X__X___XX_X___X_X_X___X__X____X__XX__XXX_____XXX__XX_______X___XX_X___
X___XXXXXX__X_XX_XX__XX___XXX_XXX_____XX______X__X_X__X__XXX____X_X___XX_X_X____X___X_XX____________
_XXX_X_XXX______X___XXX__X_X______X_X___X____X_X____X______X_X__X___XX___X_XX___X_____XXXX__XXX_X_X_
__XX_XXXX_X____X__X_____XX_____X___________X_X___X__XXX_X____X_X_____XX___XX__X______X__X___X____X__
X_X_X__X___X_X_XX____X____X__X__X_X___XX__X_X__X_____X________X___XXXX____X____XXX___XX__XX__XX__X__
____XXX__X________________________X___X__________X__X____X_______XX_X__XX_XX__X___XX_X_____X__XXXXX_
__XX__XX_X_X__XX____XX______X______XXX_X_XX_____X____X_X_XX_________X__XX__XX_X________X___X_X___XX_
__XX____XXXX_X___XX________XX_X___X__XX_X______X_X_____X_X______X________X_XXXX____X_XX______X_X____
XX_XXXX_X__XX__XX___X______X_XX_______X_X________________XXX__X__X_____X_____X_X_XXXX_X___XXX_______
__X___X___X___X_X__X___X___X__X__X__XX_X_____X_______XX_X___XX_XX____X_____XX___X_XX____X_____XXXX__
___XXXX_X_X___X__XXX__X______________X_X__XX___XXX______X____XX__XX____X____X____X_X_XX_____X_XX_X__
X__X__X___X___X____X_______X__XX_X__X_XX_X_X__X____XX_X________X__X___XX_X___XX__________X____X_____
___X________________X_________X__X____X_____X_XX_XX____X____X_____X___X_X_XXX_X_______XX_X____X_X_X_
____XXX_____X_____X____X_X__X_X____XX__X_X___X____X____X_________X__X_XX_X___X____X____X______XX____
___X___XX__X_____XXX________________X_X_X_XX__XXXXX____X______XX_____XXX___________X_____XXX__X_____
X___XX__X_X_______XX_X_XX____X_X__X_XXX_XX__X____X____X__X_____XXX___X_XX__X_____X_XX_X_X_X______X__
________X___XX_XX__XXX______X________X___XXX_X___XXX__X__X___X_X_XXX_X__X_XX__XXX_X_X__X_X___X_XXXX_
___X_X_X_______________XX_XX__XXX_X__X____X______X______XX____X___XX_X_______X___XXXX_______________
__X_X___X_X__X__X___X_____X________XXX__XX_XXX__XXX___XX_X_______X__X________X_X_XXX_XX___X___X__XX_
__XX__XX______X__X_XX_____X__________________X_______X___X_X_______X__X__X__XXX___X_X__X____XX__X___
XX__X__X_X___XX___X_XXX_XX__XX________X_X_X__XXXXXXXX___X_X__X__X_X__XXX__XX___X___________X__X_X___
____X__XX_______XX____X___X_X___X_____XX_______X__XX_X______X______XX_____X__X________X_____X_____X_
X_______XXXXX_XXX__X______XXX_X_____________X_X__X_XX____X______X_X_X___X____X_X_XX__X_XXX_X______X_
____X_XX__X_XX__X__XXX_XX_X_____X____XX_XX_X__XX__X__XX_XXXX__________X__________X__XX_____X__XXXX__
_X_X___X__X______X_XX_X___X___________X____XX_____X_XXXXX______X_XXX_X_____X__XX__X______XXXX_X_X___
_X_XXXX___XX_XX_XX_______X___XXX_____X_X__X__XX____XXX_X_________XX_______X______X__X__X_X___X______
___X___XX__XXXX__X_XX__XX___X____X__________X___X_____X_____X__XXX_XX_X_X_XXXX___X__X___X__X__X__XX_
XX_X_____XXXX_X_____X_____XXXX__XXX__X_XX____X_XX___X_____X_X________XX_X_X_X_X_XX__X___XX_____X_X__
__X__X______X____X______X___X____X___X____X__X_____XX_X_______XX_X____X__X______X_________X_____X___
___XX__X_XX______X__X______X__X____X____X__________X_XX___X_X______X_____XX__X_____XXXXX__X______XX_
__X__XXX_X_XX_XX___X_____XXX_X__________X________XX_XX____XX__X_X____X____X_____X____X___XX__X_X_X__
X______X___X__XX___________X_____XXX_X_______X__________XX__X____X__X____X_X___X______X____X_X____X_
__XX___XXX_________X_______X_____X______X_____X_______XX_X_____XX__XX_XXX_____XXX_X__X__XX__X____X__
___X__X_X_X_X___XXX_X___X_____X__X_____XXX________X_X_____X__XX___XX__XX__X_______X_____X___X_______
_____X__XXXX________X_______XX_X__X__X__X____XX_XX__X_____XX____X_____X___XXX_X__XX________XX_X_X___
_XXX_XX_X_________X_XX___X_____X____X______X_X__XXX______XX__XXXXX__X_____X_X___XX__XXXX_X______XX__
__XX___X_X_X_______X_____X__X___X___XX_X_X________X___X_X_X______X___X_XX___XX____X_X___________X___
__X______XX__X_______X____X____X_______XXXXX__XX________X______XX______X__F_____X______XXX_X___XX___
XX_X_X_X___X______X_X___X__X_X_X_______X_______________________X_X__X______X__X______X_X____XX______
__X____XX______X__XX__X__X___X_X_X_XX__X_X_X_X___X___XXXXX_XX_X____X_XXX______X____X__X_X__X___X____
X_X___X______X____X_X_______X___________XX_X___XX_X__X___X_____X___X___X___X______XXXX_XX_XX__X___X_
X__X___X____X__X_______X____X_______X___XXX____X__X__XX____XXX___X_XXXX_X_X__XX_X______X__X______XX_
__X_____X___XX___X__X_________XX__X_______X____X__X_____X___XX____XX___X___XX_XX__XX_X_X__X___X_X___
_X_X___XX_____X____XX______X_____XX_XXXX___X__X_X__XX___X_________X_X____X_X_____X___X_X___X___XX_X_
____X____XX_X_________X__X__X___XX_XX_X___X_X_______X_______X_____________X________XX_____X_____XX__
X__X___XX____XXX_X_X___X____X_____X_____XX___XX_______X___X_XX_____X____X___XX__X__XX___X___X_XXXXX_
X___X__XX____X__X__XX___XX__X__X__X_______XXX__XX__X___XX___X__X_X_X____X_XXX___X__________X__X_X___
XX__X_____XX_XX__X__XXX_X_X___X_X_X_____X__X__________XX___X__XXX__X___X__X_X_XX_X_X___________XXXX_
_X_X_X__X_X__XX_____XX____XX__X______X__XX_____X____________XX_____X_X___XX_XX_X____XX_X______XXX_X_
____XXX_XXXX_XX___X_X_________X___X____X____X__X________XXX__X____XX__XXXXXX___X_X_X__X_XX_XXX__X_X_
______X__X_____X___XXX_X_______X___X____XX_X_X___X___X_XX_____X___X____XX__X_XX_X_X___X_____X_X_____
XX_____X___XX_X_X_X_XX_X_X__X__X_______X___X__XX_XX_X__X__X_X_X___XX____________X__XX__X_______X_XX_
____X_________XX_XX__XX_XX__X_XX_____________X_______XXXX______X___X__X__XX_X__XX______X__XX________
___X__X__X__XX_XXX_X____XX__X___X___XX_XXX_____________X_X_XXXX_____X__XX_X____X__X__X_______X____X_
XXX___X__X_______X_XX__________________X____X____X_X___X________X___X_X_X____X___X______X___X__X____
_______X__XX____XX_X__XXX____X___X_X__XXX_____X_XXX_XX_X_X__X_____X____X__XX_________X__X__X____X_X_
____________X_X__X___X__X__X_X_______X_XX_X___X____X_XX_________XXX___XXXXX_XXX_X_XX______X_X_XX__X_
_X____________X______XXX_X______XX_X____X______XX_X_XXX_____X_____X_X__________XX__X__X__XX_XX__X___
___X__________X___X__X____X_____X_____________X_________X_XX_______X__XX__XX_________XX_X_____X_____
___XX__X________X_____X__X___X_X__X_____X_X___XX_X__X_____X______X_____X_X_X_XX_____X______X_XX_X_X_
____X___________X___X___XX__X___X_____________X__________X________XXX___XX_X____________X_XXXX_X____
__X_______XX_________X_X____X__X_X___X___X__XX___XX_X___XX____XX__X_XXX__X___X______XXX_____X_____X_
X__XX_X__X_XX__________X__XX_______X_X__________________XXX_XX___XX_____XXX_X_X___X_____XX_X________
__X_____X_X__XX____X__XX_XX______XX__X______X____X____X__XX__X_XX____XX______X___________X_______X__
__XX____XX____XX__X_____X__X_XX______XX___XX_______X_X___X__XX_X__XX_X_X__X___XXXX__XX__X_XX________
___X_X__XX_____XX__X_X___XXXX_______XX__XX______XX_X_____X_X____XXX___X_X_XXX_XX_X__X_X___X____X____
___XXXXX_______XX__X__________X__X_X_X_X__X_X___X_____________X_X__XXXX___X___XX_X______X___X____X__
___XX_X_X__X___X__X______XX__XX_____X_X______XX__X_________XXX__X_______X___XX__X_X___XX____XX______
XX_XX__X_XX___XX______X__XXX________XX__X_____XX________XX_____X____X______X_XXX___XX_XX__XX____X_X_
_XX_X_X___X_X_X___XX_XX_X____X__X_________XX__X______________X______X_XXXX___X_XX____X____XX___X_X__
______________XXX_XX__XX__X_____X___X_X__X____X____________X___XX______XX___XX_X____XX_X_________X__
X___XXX_XX_____XX________X_XXX_XX___XX___X_____X______X_XX__XXX_X_X_X____X__X__X____X__XX____X___X__
__________X____X__________X_X_X___X______X_X__X__X_X___X____X___X_____XX__X____X_____X_X____XX_XX_X_
__X_XXX_XX_________X_____X__X_X__X____X_X_____X_________X_X__________X_X_____XXX___XXX_X_X__X_X_____
X___X_XX__X_XX__X_____X_____XXX________XXX_______XX_X__X_XXX__XX___X__X__XX_____X_X_X_X__X__XX_X__X_
_X___XXX__X_X_XX_X__X__X__X_XXXX_X___X___XX_XX___XX_____XX_____XXX___XX_____XX___XX_XX______________
X_X___X______XX______XX_X___XX______X_X____X_X_XX______X_X____XXX_X___X__X____________X_____X___X_X_
_X____X_______X__X__X_X_XX_XX__X____X__X_____________X____X__XX_X__XX_X____XXX______X__X_X_X____X___
_________X_X__X__X__X___X___X___X___X_XX____X__X___X___X___X__X_X____X_____X_____XX__X_X__________X_
____________________________________________________________________________________________________